set: industrialb
dimension:
| origin: -7, 1.5
| matrix: 11 rows by 32 columns
| size: 14 by 6
| tiles: auto
arena:
................................
.......ABBBC........ABBBC.......
................................
...............M................
...............M................
...............M................
...............M................
...............M................
...............M................
...............M................
.ABBBBBBBBBBBBBBBBBBBBBBBBBBBBC.
end