set: industrial
dimension:
| origin: -7, 1.5
| matrix: 9 rows by 30 columns
| size: 14 by 6
| tiles: auto
arena:
..............................
.......ABBBC......ABBBC.......
..............................
..............................
..............................
..............................
..............................
..............................
.ABBBBBBBBBBBBBBBBBBBBBBBBBBC.
end